width = Define uma largura para o elemento;
height = Define uma altura para o elemento.

background =	cor de fundo, imagem, transparência.
background-attachment =	rolagem do fundo / marca d’água.
background-image =	imagem de fundo.
background-color =	cor de fundo ou transparência.
background-position =	posicionamento da imagem de fundo.
background-repeat =	configuração lado-a-lado da imagem de fundo.

border =	largura, estilo e cor de todas as 4 bordas.
border-bottom =	largura, estilo e cor da borda inferior.
border-bottom-color =	cor da citada borda.
border-bottom-style =	estilo da citada borda.
border-bottom-width =	largura da citada borda.
border-color =	cor das 4 bordas.
border-left =	largura, estilo e cor da borda esquerda.
border-left-color =	cor da borda citada.
border-left-style =	estilo da borda citada.
border-left-width = 	largura da borda citada.
border-right =	largura, estilo e cor da borda direita.
border-right-color = 	cor da borda citada.
border-right-style =	estilo da borda citada.
border-right-width =	largura da borda citada.
border-style =	estilo de todas as 4 boras.
border-top =	largura, estilo e cor da borda superior.
border-top-color =	cor da borda citada.
border-top-style =	estilo da borda citada.
border-top-width =	largura da borda citada.
border-width =	largura de todas as 4 bordas.

clear =	elementos flutuantes à esquerda ou à direita de um elemento.


clip =	parte visível de um elemento.

color =	cor de primeiro plano.

cursor =	tipo de ponteiro do mouse.

display =	se o elemento é exibido e o espaço é reservado para ele.

filter =	tipo de filtro aplicado ao elemento.


float =	se o elemento flutua.

font =	estilo, variante, peso, tamanho e altura da linha do tipo de fonte.
font-face =	incorporação da fonte ao arquivo html.
font-family =	tipo de fonte.
font-size =	tamanho da fonte.
font-style =	fonte itálico.
fonte-variant =	fonte bold.
font-weight =	peso da fonte de claro a negrito.

height =	altura exibida ao elemento.

import =	folha de estilo a importar.

left =	posição do elemento em relação a margem esquerda da página.

letter-spacing =	distância entre as letras.

line-height =	distância entre linhas de base.

list-style =	tipo, imagem e posição do estilo da lista.
list-style-image =	marcador de item de lista.
list-style-position =	posição do marcador de item da lista.
list-style-type =	marcador de item de lista alternativo.

margin =	tamanho de todas as 4 margens.
margin-left =	tamanho da margem esquerda.
margin-right =	tamanho da margem direita.
margin-bottom =	tamanho da margem inferior.
margin-top =	tamanho da margem superior.

overflow =	exibição de imagens que são maiores do que suas molduras.

padding =	espaço em torno de um elemento em todos os lados.
padding-bottom =	espaço a partir da margem inferior de um elemento.
padding-left =	espaço à esquerda do elemento.
padding-right =	espaço à direita do elemento.
padding-top =	espaço a partir da margem superior do elemento.

page-break-after =	inserir quebra de página depois de um elemento.
page-break-before =	inserir quebra de página antes de um elemento.

position =	como o elemento é posicionado na página.

text-align =	alinhamento do texto.
text-decoration =	sublinhado, sobrelinhado ou riscado.
text-indent =	recuo da primeira linha do parágrafo.
text-transform =	transformação para todas maiúsculas, minúsculas ou inicial maiúscula.

top =	posição do elemento em relação a parte superior da página.

vertical-align =	alinhamento vertical do elemento.

visibility =	se elemento é visível ou invisível.

width =	largura do elemento.

z-index =	posição do elemento na pilha.